#map_info
#tiles
10|10|10|11|11|10|10|10|10|10|10|10|10|10|10|10|10|10|10|0|0|0|0|0|
10|10|10|10|10|10|10|10|10|10|10|12|12|12|12|10|10|10|10|0|0|0|0|0|
12|10|10|10|10|10|10|11|11|10|12|12|12|12|12|12|10|10|10|0|0|0|0|0|
12|12|12|10|10|11|11|11|11|11|12|12|12|12|12|12|10|10|10|0|0|0|0|0|
12|16|16|16|16|16|16|16|16|16|16|16|16|17|18|12|10|10|10|0|0|0|0|0|
12|16|17|18|11|11|10|10|10|10|10|11|16|17|18|11|10|10|10|0|0|0|0|0|
11|16|17|40|42|10|10|21|10|10|21|10|16|17|18|11|11|10|10|0|0|0|0|0|
11|16|17|41|43|10|10|10|10|10|10|10|16|17|18|11|10|10|10|0|0|0|0|0|
10|16|17|18|11|10|10|10|10|10|10|10|16|17|18|10|10|10|10|0|0|0|0|0|
10|16|17|18|57|10|10|21|10|10|21|10|16|17|18|10|10|10|10|0|0|0|0|0|
10|16|17|18|10|10|10|10|10|10|10|10|16|17|18|10|12|10|10|0|0|0|0|0|
10|19|20|4|10|10|10|10|10|10|10|10|16|17|18|12|12|10|10|0|0|0|0|0|
10|19|20|4|10|10|10|10|10|10|10|10|16|17|18|12|10|10|12|0|0|0|0|0|
10|16|17|18|10|10|10|10|10|10|10|10|16|17|18|12|10|12|12|0|0|0|0|0|
10|16|17|18|10|10|10|10|10|10|10|10|16|17|18|10|12|12|12|0|0|0|0|0|
11|16|17|18|10|10|10|10|28|30|10|10|16|17|18|11|12|12|10|0|0|0|0|0|
12|16|17|18|10|10|10|10|29|31|10|10|16|17|18|11|11|12|10|0|0|0|0|0|
12|16|17|18|11|10|10|10|11|10|11|11|16|17|18|11|11|10|10|0|0|0|0|0|
12|16|17|18|11|11|10|10|10|10|11|10|16|17|18|11|12|10|10|0|0|0|0|0|
10|16|16|16|16|16|16|16|16|16|16|16|16|17|18|11|10|10|10|0|0|0|0|0|
10|10|12|12|11|11|11|11|10|11|12|11|10|10|11|10|11|10|10|0|0|0|0|0|
10|10|10|12|12|11|11|12|12|12|12|10|10|10|10|10|10|10|10|0|0|0|0|0|
10|10|10|10|10|10|10|10|12|12|10|10|10|10|10|10|10|10|10|0|0|0|0|0|
10|10|10|10|10|10|10|10|10|10|10|10|10|10|10|10|10|10|10|0|0|0|0|0|
#npcs
James|10|8|0|36||0|0|0|||0|||||||
#spawns
#savepoints
#shops
6|4|default|-1`-1`-1`-1`-1|https://cdn.discordapp.com/attachments/1149873572291035298/1149873767351332976/image.png|Welcome to my store! Buy whatever you need below.|
7|4|default|-1`-1`-1`-1`-1|https://cdn.discordapp.com/attachments/1149873572291035298/1149873767351332976/image.png|Welcome to my store! Buy whatever you need below.|
#events
#transitions
11|3|map_valley1|0|0|
12|3|map_valley1|0|0|
