#tiles
11|11|11|11|10|10|10|12|12|12|12|10|10|10|10|10|10|10|10|10|10|12|12|12|
12|16|16|16|16|16|16|16|16|16|16|16|16|16|16|16|16|16|16|16|16|17|18|12|
11|16|17|18|11|11|10|10|10|10|10|10|10|10|10|10|10|10|10|10|16|17|18|12|
10|16|17|18|11|10|10|21|10|10|21|10|10|10|21|10|10|21|10|10|16|17|18|10|
10|16|17|18|10|10|10|10|10|10|10|10|10|10|10|10|10|10|10|10|16|17|18|10|
12|19|20|4|10|10|10|10|10|10|10|10|10|10|10|10|10|10|10|6|19|20|20|10|
12|19|20|4|10|10|10|10|10|10|10|10|10|10|10|10|10|10|10|6|19|20|20|10|
12|16|17|18|10|10|10|10|10|10|10|10|10|10|10|10|10|10|10|10|16|17|18|10|
10|16|17|18|10|10|10|10|10|10|10|10|10|10|10|10|10|10|10|10|16|17|18|10|
10|16|17|18|10|10|10|12|12|12|12|10|10|10|10|10|10|10|10|10|16|17|18|10|
12|16|17|18|10|10|10|12|12|12|12|10|10|10|10|10|10|10|10|10|16|17|18|10|
12|16|17|18|10|10|10|12|12|12|12|10|10|10|12|12|12|12|12|12|16|17|18|10|
12|16|17|18|10|10|10|12|12|12|12|10|10|10|12|12|12|12|12|12|16|17|18|10|
12|16|17|18|11|10|10|10|10|10|10|10|10|10|12|12|12|12|12|12|16|17|18|10|
10|16|17|18|11|11|10|10|10|10|10|10|10|10|10|10|10|12|12|12|16|17|18|10|
10|16|17|18|10|10|10|10|10|10|10|10|10|10|10|10|10|12|12|12|16|17|18|10|
10|16|17|18|10|10|10|10|10|10|10|12|12|12|12|12|10|10|10|10|16|17|18|11|
11|16|17|18|10|10|10|10|10|10|10|12|12|12|12|12|10|10|10|11|16|17|18|10|
11|16|17|18|12|12|10|10|10|10|10|12|12|12|12|12|10|10|11|11|16|17|18|10|
11|16|17|18|12|12|10|10|10|10|10|10|10|10|10|10|10|10|10|10|16|17|18|10|
10|16|17|18|12|12|12|12|12|10|10|10|10|10|10|10|10|10|10|10|16|17|18|10|
12|16|17|18|12|12|12|12|12|10|10|10|10|10|10|10|10|10|10|10|16|17|18|11|
11|16|16|16|16|16|16|16|16|16|16|16|16|16|16|16|16|16|16|16|16|17|18|11|
11|10|10|10|10|10|10|10|10|10|11|11|11|10|10|10|10|11|11|12|11|10|10|11|
#npcs
Mimic Chest|15|9|0|2|1000|6|1|||0||||17`Charlite`9`6`0`-1`-1`-1`1`1.20`1`1`||||||
BATTLEMAN|3|12|0|25|256|1|1|||0|Fight me or fight me.`The choice is yours.`|GG EZ`|How could it end like this?!`|0`Sporbee`0`2`1`2`-1`-1`1`1`1`1`|3`Roocky`4`3`3`1`-1`-1`1`1`1`1`|6`Puppyre`8`4`0`-1`-1`-1`2`2`2`2`||||
Barry|8|8|1|22|50|0|0|||0|Here, have some coins for free!`|||||||||
#spawns
9|7|4|4|13`1`5`|0`6`10`|||||||
18|4|4|5|17`11`11`||||||||
16|11|3|5|9`2`1`||||||||
11|14|5|6|28`35`40`||||||||
#savepoints
8|16|1|
14|11|0|
#events
2|18|8|2|evNearBottom||flBottom|
#transitions
6|3|testmap|6|18|
5|3|testmap|5|18|
6|19|testmap|6|4|
5|19|testmap|5|4|
